// Nom : Slimani 
// Prénom : Arezki
// n° étudiant : 21502933

//Fichier niveau.xsb du jeu SOKOBAN 